##########################################
####..................................####
##......................................##
#..............................g.........#
#........................................#
#........................................#
#........................................#
#........................................#
#.............############...............#
#.............############...............#
#.............############...............#
#.............############...............#
#.............############...............#
#.............############...............#
#.............############...............#
#.............############...............#
#.............############...............#
#.............############...............#
#.............############...............#
#.............############...............#
#........................................#
#........................................#
#........................................#
#........................................#
#........................................#
#...................a....................#
#........................................#
#........................................#
#........................................#
##......................................##
####..................................####
##########################################
