##########################################
####..................................####
##......................................##
#........................................#
#........................................#
#........................................#
#........................................#
#........................................#
#........................................#
#........................................#
#........................................#
#........................................#
#........................................#
#.........a..............................#
#........................................#
#........................................#
#........................................#
#.............############...............#
#.............############...............#
#.............############...............#
#........................................#
#........................................#
#.............................g..........#
#........................................#
#........................................#
#........................................#
#........................................#
#........................................#
#........................................#
##......................................##
####..................................####
##########################################
