##########################################
####..................................####
##......................................##
#........................................#
#........................................#
#........................................#
#........................................#
#........................................#
#..................................a.....#
#........................................#
#.................####...................#
#.................####...................#
#.................####...................#
########.....#########...................#
#.................###############........#
#.................##############.........#
#.................####...................#
#######........###########...............#
#.............############...............#
#....................#####...............#
#.................#######................#
#........................................#
#........................................#
#......g.................................#
#........................................#
#........................................#
#........................................#
#..................##....................#
#..................##....................#
##.................##...................##
####...............##.................####
##########################################
