##########################################
####..................................####
##......................................##
#........................................#
#........................................#
#........................................#
#........................................#
#........................................#
#........................................#
#........................................#
#........................................#
#........................................#
#................................a.......#
#........................................#
#........................................#
#........................................#
#........................................#
#........................................#
#........................................#
#........................................#
#........................................#
#........................................#
#........................................#
#........................................#
#........................................#
#........................................#
#.........g..............................#
#........................................#
#........................................#
##......................................##
####..................................####
##########################################
