##########################################
####..................................####
##......................................##
#........................................#
#........................................#
#........................................#
#........................................#
#........................................#
#........................................#
#........................................#
#........................................#
#........................................#
#........................................#
#...........##########...................#
#.................####...................#
#.............a...####...................#
#.................####...................#
#.............############...............#
#.............############...............#
#.............############...............#
#........................................#
#........................................#
#.............................g..........#
#........................................#
#........................................#
#........................................#
#........................................#
#........................................#
#........................................#
##......................................##
####..................................####
##########################################
