##########################################
####..................................####
##......................................##
#........................................#
#.................................g......#
#........................................#
#........................................#
#........................................#
#........................................#
#........................................#
#........................................#
#........................................#
#........................................#
#........................................#
#........................................#
#........................................#
#........................................#
#........................................#
#........................................#
#........................................#
#........................................#
#........................................#
#...................................a....#
#........................................#
#........................................#
#........................................#
#........................................#
#........................................#
#........................................#
##......................................##
####..................................####
##########################################
